16 206 9
00000000000000000000000000000000000000000000000000000000000000000000000000000000000000000000000000000000000000000000000000000000000000000000000000000000000000000000000000000000000000000000000000000000000000
00000000000000000000000000000000000000000000000000000000000000000000000000000000000000000000000000000000000000000000000000000000000000000000000000000000000000000000000000000000000000000000000000000000000000
00000000000000000000000000000000000000000000000000000000000000000000000000000000000000000000000000000000000000000000000000000000000000000000000000000000000000000000000000000000000000000000000000000000000000
00000000000000000000000000000000000000000000000000000000000000000000000000000000000000000000000000000000000000000000000000000000000000000000000000000000000000000000000000000000000000000000000000000000000000
00000000000000000000000000000000000000000000000000000000000000000000000000000000000000000000000000000000000000000000000000000000000000000000000000000000000000000000000000000000000000000000000000000000000000
00000000000000000000000000000000000000000000000000000000000000000000000000000000000000000000000000000000000000000000000000000000000000000000000000000000000000000000000000000000000000000000000000000000000000
00000000000000000000003000000000000000000000000000000000000000000000000000000000444444440004443000000000000003000000000004440000043340000000000000000000000000000000000000000000000000000000001100000000000000
00000000000000000000000000000000000000000000000000000000000000000000000000000000000000000000000000000000000000000000000000000000000000000000000000000000000000000000000000000000000000000000011100000000000000
00000000000000000000000000000000000000000000000000000000000000000000000000000000000000000000000000000000000000000000000000000000000000000000000000000000000000000000000000000000000000000000111100000000000000
00000000000000000000000000000000000000000000000000000000000000000000000000000000000000000000000000000000000000000000000000000000000000000000000000000000000000000000000000000000000000000001111100000000000000
00000000000000003000434340000000000000000000005600000000056000000000000000000434000000000000004000004400003003003000004000000000004400000010010000000000011001000000000000443400000000000011111100000000000000
00000000000000000000000000000000000000560000007800000000078000000000000000000000000000000000000000000000000000000000000000000000000000000110011000000000111001100000000000000000000000000111111100000000000000
00000000000000000000000000005600000000780000007800000000078000000000000000000000000000000000000000000000000000000000000000000000000000001110011100000001111001110000056000000000000005601111111100000000000000
00000000000000000000000000007800000000780000007800000000078000000000000000000000000000000000000000000000000000000000000000000000000000011110011111000011111001111000078000000000000007811111111100000000100000
22222222222222222222222222222222222222222222222222222222222222222222200222222222222222000222222222222222222222222222222222222222222222222222222222222222222002222222222222222222222222222222222222222222222222
22222222222222222222222222222222222222222222222222222222222222222222200222222222222222000222222222222222222222222222222222222222222222222222222222222222222002222222222222222222222222222222222222222222222222