0022000200020200020200020200020200020200020200000000300000000000000000000000000000000000000000000000000000000000000000000000000000
0200202020200020200020200020200020200020200020222222000000000000000000000000000000000000000000000000000000000000000000000000000000
0022000200020200020200020200020200020200020200000000300000000000000000000000000000000000000000000000000000000000000000000000000000
0200202020200020200020200020200020200020200020222222000000000000000000000000000000000000000000000000000000000000000000000000000000
0022000200020200020200020200020200020200020200000000300000000000000000000000000000000000000000000000000000000000000000000000000000
0200202020200020200020200020200020200020200020222222000000000000000000000000000000000000000000000000000000000000000000000000000000
0022000200020200020200020200020200020200020200000000300000000000000000000000000000000000000000000000000000000000000000000000000000
0200202020200020200020200020200020200020200020222222000000000000000000000000000000000000000000000000000000000000000000000000000000
0022000200020200020200020200020200020200020200000000300000000000000000000000000000000000000000000000000000000000000000000000000000
0200202020200020200020200020200020200020200020222222000000000000000000000000000000000000000000000000000000000000000000000000000000
0022000200020200020200020200020200020200020200000000300000000000000000000000000000000000000000000000000000000000000000000000000000
0200202020200020200020200020200020200020200020222222000000000000000000000000000000000000000000000000000000000000000000000000000000
0022000200020200020200020200020200020200020200000000300000000000000000000000000000000000000000000000000000000000000000000000000000
0200202020200020200020200020200020200020200020222222000000000000000000000000000000000000000000000000000000000000000000000000000000
0022000200020200020200020200020200020200020200000000300000000000000000000000000000000000000000000000000000000000000000000000000000
0200202020200020200020200020200020200020200020222222000000000000000000000000000000000000000000000000000000000000000000000000000000
0022000200020200020200020200020200020200020200000000300000000000000000000000000000000000000000000000000000000000000000000000000000
0200202020200020200020200020200020200020200020222222000000000000000000000000000000000000000000000000000000000000000000000000000000
2000020002000002000002000002000002000002000002000000000000000000000000000000000000000000000000000000000000000000000000000000000000
2222222222222222222222222222222222222222222222222222220000000022222222222222222222222222222222222222222222222222222222222222222222